50
50
37 0 0 0 0 0 0 0 0 0 0 0 0 0 0 0 40 22 22 22 22 37 0 0 0 0 0 0 0 0 0 0 0 24 22 21 0 0 0 0 0 0 0 0 0 0 0 0 28 22 
37 0 0 0 0 0 0 0 0 0 0 0 0 0 0 0 40 22 22 22 22 21 0 0 0 0 0 0 0 0 0 0 0 24 22 21 0 0 0 0 0 0 0 0 0 0 0 0 24 22 
37 0 0 0 0 0 0 0 0 0 0 0 0 0 0 0 40 22 22 22 22 30 17 29 0 0 0 0 0 0 0 0 0 24 22 21 0 0 0 0 0 0 0 0 0 0 0 0 40 22 
37 0 0 0 0 0 0 0 0 0 0 0 0 0 0 0 40 22 22 22 22 46 33 45 0 0 0 0 0 0 0 0 0 24 22 21 0 0 0 0 0 0 0 0 0 0 0 0 40 22 
37 0 0 0 0 0 0 0 0 0 0 0 0 0 0 0 40 22 22 22 22 37 0 0 0 28 29 0 0 0 0 0 0 44 33 45 0 0 28 29 0 0 0 0 0 0 0 0 24 22 
37 0 0 0 0 0 0 0 0 0 0 0 0 0 0 0 40 22 22 22 22 21 0 0 0 44 45 0 0 0 0 0 0 0 0 0 0 0 24 30 29 0 0 0 0 0 0 0 24 22 
37 0 0 0 0 0 0 0 0 0 0 0 0 0 0 0 40 22 22 22 22 21 0 0 0 0 0 0 28 29 0 0 0 25 0 0 0 0 24 22 30 17 16 17 17 16 19 19 23 22 
37 0 0 0 0 0 0 0 0 0 0 0 0 0 0 0 40 22 22 22 22 37 0 0 0 0 0 0 44 45 0 28 27 26 19 19 19 19 23 22 22 22 22 22 22 22 22 22 22 22 
37 0 0 0 0 0 0 0 0 0 0 0 0 0 0 0 40 22 22 22 22 37 0 0 28 17 29 0 0 0 0 24 22 22 22 22 22 22 22 22 22 22 22 22 22 22 22 22 22 22 
21 0 0 0 0 0 0 0 0 0 0 0 0 0 0 0 40 22 22 22 22 21 0 0 40 22 30 17 16 17 27 23 22 22 22 22 22 22 22 22 22 22 22 22 22 22 22 22 22 22 
21 0 0 0 0 0 0 0 0 0 0 0 0 0 0 0 40 22 22 22 22 21 0 0 24 22 22 22 22 22 22 22 22 33 32 33 33 32 33 33 33 33 32 33 33 32 33 33 47 22 
21 0 0 0 0 0 0 0 0 0 0 0 0 0 0 0 24 22 22 22 22 37 0 0 24 22 22 22 22 22 22 22 22 0 0 0 0 0 0 0 0 0 0 0 0 0 0 0 40 22 
21 0 0 0 0 0 0 0 0 0 0 0 0 0 0 0 24 22 22 22 22 21 0 0 40 22 22 22 22 22 22 22 22 0 0 0 0 0 0 0 0 0 0 0 0 0 0 0 24 22 
21 0 0 0 0 0 0 0 0 0 0 0 0 0 0 28 31 22 22 22 22 37 0 0 24 22 22 22 22 22 22 22 22 0 0 0 0 0 0 0 0 0 0 0 0 0 0 0 24 22 
30 17 16 16 17 17 16 16 17 29 48 25 0 0 0 44 47 22 22 22 22 21 48 48 24 22 22 22 22 22 22 22 22 25 0 0 28 29 0 0 28 17 17 16 17 17 27 19 23 22 
46 33 33 32 32 43 35 35 34 45 0 0 0 0 0 0 40 22 22 22 22 21 0 0 24 22 22 22 22 22 22 22 22 41 48 48 44 45 0 0 24 22 22 22 22 22 22 22 22 22 
37 0 0 0 0 0 0 0 0 0 0 0 0 25 48 48 40 22 22 22 22 21 0 0 24 22 22 22 22 22 22 22 22 0 0 0 0 0 0 0 40 22 22 22 22 22 22 22 22 22 
37 0 0 0 0 0 0 0 0 0 0 0 0 41 0 0 44 35 35 35 34 45 0 0 40 22 22 22 22 22 22 22 22 17 17 16 16 27 19 19 23 22 22 22 22 22 22 22 22 22 
21 0 0 0 0 0 0 0 0 0 25 0 0 0 0 0 0 0 0 0 0 0 0 0 40 22 22 22 22 22 22 22 22 22 22 22 22 22 22 22 22 22 22 22 22 22 22 22 22 22 
21 48 48 28 29 0 25 0 0 0 41 0 0 0 0 0 28 27 19 19 19 19 19 19 23 22 22 22 22 22 22 22 22 22 22 22 22 22 22 22 22 22 22 22 22 22 22 22 22 22 
21 0 0 44 45 48 41 0 0 0 0 0 0 0 0 28 31 22 22 22 22 22 22 22 22 22 22 22 22 22 22 22 22 0 0 0 0 0 0 0 0 0 0 0 0 0 0 0 0 0 
30 29 0 0 0 0 0 0 0 0 25 0 0 0 0 40 22 22 22 22 22 22 22 22 22 22 22 22 22 22 22 0 0 0 0 0 0 0 0 0 0 0 0 0 0 0 0 0 0 0 
22 20 18 16 17 16 16 17 16 27 26 18 17 17 27 23 22 22 22 22 22 22 22 22 22 22 22 22 0 0 0 0 0 0 0 0 0 0 0 0 0 0 0 0 0 0 0 0 0 0 
22 22 22 22 22 22 22 22 22 22 22 22 22 22 22 22 22 22 22 22 22 22 22 22 22 22 22 22 22 22 22 22 0 0 0 0 0 0 0 0 0 0 0 0 0 0 0 0 0 0 
22 22 22 22 22 22 22 22 22 22 22 22 22 22 22 22 22 22 22 22 22 22 22 22 22 22 22 22 22 22 22 22 0 0 0 0 0 0 0 0 0 0 0 0 0 0 0 0 0 0 
22 22 22 22 22 22 22 22 22 22 22 22 22 22 22 22 22 22 22 22 22 22 22 22 22 22 22 22 22 0 0 0 0 0 0 0 0 0 0 0 0 0 0 0 0 0 0 0 0 0 
0 0 0 0 0 0 0 0 0 0 0 0 0 0 0 0 0 0 0 0 0 0 0 0 0 0 0 0 0 0 0 0 0 0 0 0 0 0 0 0 0 0 0 0 0 0 0 0 0 0 
0 0 0 0 0 0 0 0 0 0 0 0 0 0 0 0 0 0 0 0 0 0 0 0 0 0 0 0 0 0 0 0 0 0 0 0 0 0 0 0 0 0 0 0 0 0 0 0 0 0 
0 0 0 0 0 0 0 0 0 0 0 0 0 0 0 0 0 0 0 0 0 0 0 0 0 0 0 0 0 0 0 0 0 0 0 0 0 0 0 0 0 0 0 0 0 0 0 0 0 0 
0 0 0 0 0 0 0 0 0 0 0 0 0 0 0 0 0 0 0 0 0 0 0 0 0 0 0 0 0 0 0 0 0 0 0 0 0 0 0 0 0 0 0 0 0 0 0 0 0 0 
0 0 0 0 0 0 0 0 0 0 0 0 0 0 0 0 0 0 0 0 0 0 0 0 0 0 0 0 0 0 0 0 0 0 0 0 0 0 0 0 0 0 0 0 0 0 0 0 0 0 
0 0 0 0 0 0 0 0 0 0 0 0 0 0 0 0 0 0 0 0 0 0 0 0 0 0 0 0 0 0 0 0 0 0 0 0 0 0 0 0 0 0 0 0 0 0 0 0 0 0 
0 0 0 0 0 0 0 0 0 0 0 0 0 0 0 0 0 0 0 0 0 0 0 0 0 0 0 0 0 0 0 0 0 0 0 0 0 0 0 0 0 0 0 0 0 0 0 0 0 0 
0 0 0 0 0 0 0 0 0 0 0 0 0 0 0 0 0 0 0 0 0 0 0 0 0 0 0 0 0 0 0 0 0 0 0 0 0 0 0 0 0 0 0 0 0 0 0 0 0 0 
0 0 0 0 0 0 0 0 0 0 0 0 0 0 0 0 0 0 0 0 0 0 0 0 0 0 0 0 0 0 0 0 0 0 0 0 0 0 0 0 0 0 0 0 0 0 0 0 0 0 
0 0 0 0 0 0 0 0 0 0 0 0 0 0 0 0 0 0 0 0 0 0 0 0 0 0 0 0 0 0 0 0 0 0 0 0 0 0 0 0 0 0 0 0 0 0 0 0 0 0 
0 0 0 0 0 0 0 0 0 0 0 0 0 0 0 0 0 0 0 0 0 0 0 0 0 0 0 0 0 0 0 0 0 0 0 0 0 0 0 0 0 0 0 0 0 0 0 0 0 0 
0 0 0 0 0 0 0 0 0 0 0 0 0 0 0 0 0 0 0 0 0 0 0 0 0 0 0 0 0 0 0 0 0 0 0 0 0 0 0 0 0 0 0 0 0 0 0 0 0 0 
0 0 0 0 0 0 0 0 0 0 0 0 0 0 0 0 0 0 0 0 0 0 0 0 0 0 0 0 0 0 0 0 0 0 0 0 0 0 0 0 0 0 0 0 0 0 0 0 0 0 
0 0 0 0 0 0 0 0 0 0 0 0 0 0 0 0 0 0 0 0 0 0 0 0 0 0 0 0 0 0 0 0 0 0 0 0 0 0 0 0 0 0 0 0 0 0 0 0 0 0 
0 0 0 0 0 0 0 0 0 0 0 0 0 0 0 0 0 0 0 0 0 0 0 0 0 0 0 0 0 0 0 0 0 0 0 0 0 0 0 0 0 0 0 0 0 0 0 0 0 0 
0 0 0 0 0 0 0 0 0 0 0 0 0 0 0 0 0 0 0 0 0 0 0 0 0 0 0 0 0 0 0 0 0 0 0 0 0 0 0 0 0 0 0 0 0 0 0 0 0 0 
0 0 0 0 0 0 0 0 0 0 0 0 0 0 0 0 0 0 0 0 0 0 0 0 0 0 0 0 0 0 0 0 0 0 0 0 0 0 0 0 0 0 0 0 0 0 0 0 0 0 
0 0 0 0 0 0 0 0 0 0 0 0 0 0 0 0 0 0 0 0 0 0 0 0 0 0 0 0 0 0 0 0 0 0 0 0 0 0 0 0 0 0 0 0 0 0 0 0 0 0 
0 0 0 0 0 0 0 0 0 0 0 0 0 0 0 0 0 0 0 0 0 0 0 0 0 0 0 0 0 0 0 0 0 0 0 0 0 0 0 0 0 0 0 0 0 0 0 0 0 0 
0 0 0 0 0 0 0 0 0 0 0 0 0 0 0 0 0 0 0 0 0 0 0 0 0 0 0 0 0 0 0 0 0 0 0 0 0 0 0 0 0 0 0 0 0 0 0 0 0 0 
0 0 0 0 0 0 0 0 0 0 0 0 0 0 0 0 0 0 0 0 0 0 0 0 0 0 0 0 0 0 0 0 0 0 0 0 0 0 0 0 0 0 0 0 0 0 0 0 0 0 
0 0 0 0 0 0 0 0 0 0 0 0 0 0 0 0 0 0 0 0 0 0 0 0 0 0 0 0 0 0 0 0 0 0 0 0 0 0 0 0 0 0 0 0 0 0 0 0 0 0 
0 0 0 0 0 0 0 0 0 0 0 0 0 0 0 0 0 0 0 0 0 0 0 0 0 0 0 0 0 0 0 0 0 0 0 0 0 0 0 0 0 0 0 0 0 0 0 0 0 0 
0 0 0 0 0 0 0 0 0 0 0 0 0 0 0 0 0 0 0 0 0 0 0 0 0 0 0 0 0 0 0 0 0 0 0 0 0 0 0 0 0 0 0 0 0 0 0 0 0 0 
