20
6
16 0 0 0 0 0 0 0 0 0 0 0 0 0 0 0 0 0 0 0 0
16 0 0 0 0 0 0 0 0 0 0 0 0 0 0 0 0 0 0 0 0
16 0 0 0 0 0 0 0 0 0 0 0 0 0 0 0 0 0 0 0 0
16 0 0 0 20 0 0 0 20 0 0 0 0 0 0 0 0 0 0 0 0
15 14 14 14 21 14 14 14 21 13 12 11 12 11 12 11 12 11 12 11
17 17 17 17 17 17 17 17 17 17 17 17 17 17 17 17 17 17 17 17