20
6
12 0 0 0 0 0 0 0 0 0 0 0 0 0 0 0 0 0 0 0 0
12 0 0 0 0 0 0 0 0 0 0 0 0 0 0 0 0 0 0 0 0
12 0 0 0 0 0 0 0 0 0 0 0 0 0 0 0 0 0 0 0 0
12 0 0 0 7 0 0 0 7 0 0 0 0 0 0 0 0 0 0 0 0
11 10 9 7 8 7 8 7 8 7 7 8 7 8 7 8 7 8 7 8 7
13 13 13 13 13 13 13 13 13 13 13 13 13 13 13 13 13 13 13 13