20
6
17 0 0 0 0 0 0 0 0 0 0 0 0 0 0 0 0 0 0 0 0
17 0 0 0 0 0 0 0 0 0 0 0 0 0 0 0 0 0 0 0 0
17 0 0 0 0 0 0 0 0 0 0 0 0 0 0 0 0 0 0 0 0
17 0 0 0 21 0 0 0 21 0 0 0 0 0 0 0 0 0 0 0 0
16 15 15 15 22 15 15 15 22 14 13 12 13 12 13 12 13 12 13 12
18 18 18 18 18 18 18 18 18 18 18 18 18 18 18 18 18 18 18 18